#######    B##
#####   ######
####  ########
###  #########
#   ##########
# ############
A ############